
NO ./packages/textures/3.xpm
SO ./packages/textures/1.xpm
WE ./packages/textures/2.xpm
EA ./packages/textures/4.xpm

C 155,100,160
F 111,111,111

1111111111111
10K0000000K01
1000000000001
1000000000001
1000000N00001
1000000000001
1000000000K01
111111011D111
1111110110111
1111110110111
111111011D111
1000000000001
1000000000001
1000000Z00001
1111111111111