  1111111111111
 10000000000001
10000000000000111111111
1111100000000000000001
     11110000000000011111111
        100000000001
        100000000001     111111
        110000000000111111110011
        111111110000000000000011111111 
                111111100000000000000111111
              110000000000000000000001
    1111111111000000000000001111111111111111111111111111111111111111
    1000000000000000000000001100010000000000000000000000000000000001
    100000000000000000000000110001000000N000000000000000000000000001
    1000000111111111111111111100011111111111111111111111111111111001
1111000000001000000000000000010001                              1001
100000000000100000000000000000000111111111111111111111111111111100001111111111111111111111
100000000000000000000000000000000000000000000000000000000000000000001111111111111111111111
100000000000000000000000000000000000000000000000000000000001100000000000000000000000001111
1000000N0000000000000000000000000000000000000000000000000000000000000000000000000000001111
100000000000000000000000000000000000000000001111111111111111111111111111111111111000001111
100000000000000000000000000000000000000000001                                1111000001111
111111011111111111111110001111111111100111111                                1111001001111
1111110111111         10001         1001                                     1111001001111
1111110111111         10001         1001                                     1111001001111    
1111110111111         10001         10011111111111111111111111111001001111    
1000000000001         10001         100100000000000000000000000000000000000001111001001111    
1000000000001         10001         100100000000000000000000000000000000000001111001001111    
1000000000001         11111         1001                                     1111001001111    
111100001111111111111111111111111111100111111                                1111001001111  
100000000000000000000000000000000000000000001                                1111001001111  
100000000000000000000000000000000000000000001                                1111001001111  
111111011111111111111110001111111111100111111111111111111111111111111111111111111001001111  
100000000000000000000000000000000000000000000100000000000000000000000000000000000000000001
100000000000000000000000000000000000000000000100000000000000000000000000000000000000000001
111111111111111111111111111111111111111111111111111111111111111111111111111111111111111111