                                      111
                                     10K01
        11111111111111111111          101           111111111111111111111111
    1111K000000000000000000K11111111111D11111111111100000000000000000000K1111111
1111K0000000000000000000000000000000000000000000000000000000000000000000000K1111
    1111K000000000000000000K111111111100011111111111000000000000000000001111
        11111111101111111111          101           11111111101111111111
                101                   101                   101
                101                   101                   101
                101                   101                   101
             111101111                101                111101111
            10000000001               101               10000000001
             111101111                101                111101111
                101                   101                   101
                101                   101                   101
                101                   101                   101
                100111111111111111111110111111111111111111110011111111111111111111111111111111111111111111111111111111111111111111111111111111111111111
                100000000000000000000000000000000000000000000000000000000000000000000000000000000000000000000000000000000000000000000000000000000000001
                111111111111111111111110111111111111111111111111111111111111111111111111111111111111111111111111111111111111111111111111111111111111111
                                      101
                                      101
                                      101
                                      101
                                     11011
                                    1000001
                                     11011
                                      101
111111111111111111111111111111111111111D11111111111111111111111111111111111111111111111111
1K00000000001         10001         1K00000000000000000000000000000000000000000000K1001111    
1000000000001         10001         100100000000000000000000000000000000000001111001001111    
10000000000K1         11111         10011111111111111111111111111111111111111111100D001111    
111100001111111111111111111111111111100111111                                1111001001111  
100000000000000000000000000000000000000000001                                1111001001111  
100000000000000000000000000000000000000000001                                1111001001111  
111111011111111111111110001111111111100111111111111111111111111111111111111111111D111D1111  
100000000000000000000000000000000000000000000100000000000000000000000000000000000000000001
1K00000000000000000000000000000000000000000000000000000000000000000000000000000000000000K1
111111111111111111111111111111111111111111111111111111111111111111111111111111111111111111