1111111111111111111111111111111111111111111111111111111111111
111111K000000000000000K11111111111110K11111111111111111100K11
111100000000000K000000000000000000000000000000000000000000011
1111001111111111111110011111111111000000001111111001111100011
1111001111111111111110011111111111000000001111111001111100011
1111001000000000000000000000000000001111001111111001111100011
1111001000000000000000K11111111111001111001111111111111100011
1111001000000000000000000000000000000000000000000000111100011
1111001000000000000000011111111111001111001111111100111100011
11110010000000K0000000011       1100111000011    100111100011
111100111111111111111001111111111100111000011    100111100011
111100111111111111111000000000000000000000011    100111100011
11110010000000000000D0000000000000000000000111111100111100011
111100D000000000000010011111100111111110000000000000000000K11
1111001111111111111110011111100111111110000111110001111111111
1111000000000000000000011111100111111111001111110001111111111
1111001111111111111100111111100011111111001111110001111111111
1111001           1100111111100000000000001111110001111111111
1111001           1100111111100111111111111111110001111111111
1111001           11001111111001        111111110001111111111
1111001           1100111111100111111111111111110001111111111
1111001111111111111100111111100000000000111111110001111111111
11110010000000000011001111111110000000000000000000K1111111111
1111001000000000001100111111111001111111111111110001111111111
1111001111111111111100111111111001111111111111110001111111111
1111001111111111111100111111111001111111111111110001111111111
111100000000000000010001111100111      11   11001001111111111
111100000000000000010001111100111      11   11001001111111111
1111111111111111111100111111111001111111111111111001111111111
1111             11100111111111001111111111110111001111111111
1111111111111111111100111111111001111111111110111001111111111
111111111K000000000000000000000000000000000000000001111111111
111111111K0000000000000000000000000000000000000000K1111111111
1111111111111111111111111111111111111111111111111111111111111
1111111111111111111111111111111111111111111111111111111111111
1111111111111111111111111111111111111111111111111111111111111
1111111111111111111111111111111111111111111111111111111111111
1111111111111111111111111111111111111111111111111111111111111