                                                        11111111111111111111111111111111111111111111111
                                                       1K0000000000000000000000000000000000000000000K11
      1111111111111111111111111111111111111111         1000000000000000000000000000000000000000000000011
 111111010000000000000000000000011    11111            10000000000000001000000000000000000000000000000011
 10000000000000000011110000000000111   11111111111     100000000000000000000000000000000000000000000000011
 1100000000000000001  10000000000001   11000000001     10000000000000000000000000K000000000000K000000000011
 1111111111111111111  1111111D111111   11111111101     10000000000000000000000000100000000000000000000000011
                           10001               101     1000000000K0000000000000011100000000000000000000000011
 11111111111111111     111110001111111111111   101111  1000000000000000000000001111100000000000000000000000011
 11K00000000000K11    1100000000000000000001   100001  10000000000000000000000111 11100000000000000000000000011
 10000000000000001    1000000000000000000001   1100011 100000000000000000000K111   111K0000000000000000000000K11111
 11000000000000011    1100000000000111110001   1000001 10000000000000000000000111 11100000000000000000000000011
 1K000000000000K1      1000000000001   10001   1000001 1000000000000000000000001111100000000000000000000000011
 11100000000000011111111000000000001   10001   110000111K0000000000000000000000011100000000000000000000000K11
  1111000000000000001000000000000001   10001  11100000000000000000000000000000000100000000000000000000000011
  1100000000000000000000000001111111   11111  1000111111K000000000000000000000000K0000000000000000000000011
  11111000001100000000000000000001            10001    100000000000001000000000000000000000000000000000011
111K00000000000000000000000001111111111111111110001    1000000000000010000000000110000000000000000000001
111111000000000000000000000000000000000000000000001    1000000000000010000000001000000000000000000000011
    11111100000000000000000011111111111111111000001    100000000000001000000000000000000000000000000011
        111111K00000000K111111            111111111    10000000000000000000000000000000000000000000011
            11111111001111111111                       1K00000000000000000000000000000000000000000K11
                  110011                        11111111111111110111111111111111111111111111111111111
1111111111111111111100111111111111111111111111111K000000000000000111111111111111111111111111111111
1111111111111111111100111111111111111111111111111000000111111111111111111111111111111111111111111111111
                  110011                     111100000011
                  110011                     100000000011
                  110011                     100111100011
                  110011                     1001  100011
             11111110011111111111111111111111100111100011111111111111111111111111
             1K000000000000000000000000000000000000000000000000000000000K11
             10000000000000000000K11111111111111111000000000000000000000011
             1111100000000000000001     111      1K00000000000000000000K11
                 1000000000000000K1              11000000111111111111111111
    111111111111111011111111111111111111111111111111110011111111111111111111
    1111110000000000111111111111111111111111111111111100111111111
    111111K000000000000000000000000000000000000000000000111111111
    1111111111111111111111111111111111111111111111111111111111111