  1111111111111
 1K000000000001
1K00000000000K111111111
11111000000000000000K1
     11110000000000011111111
        100000000001
        100000000001     111111
        11K000000000111111110011
        11111111K000000000000011111111 
                111111100000000000000111111
              11K000000000000000000001
    111111111100000000000000111D111111111111111111111111111111111111
    100000000000000000000000110001K0000000000000000000000000000000K1
    1000000000000000000000001100010000000000000000000000000000000001
    1000000111111111111111111100011111111111111111111111111111111001
1111000000001000000000000000010001                              1001
1K0000000000100000000000000000000111111111111111111111111111111100001111111111111111111111
100000000000000000000000000000000000000000000000000000000000000000001111111111111111111111
1000000000000000000000000000000000000000000000000000000000011000000000000000000000000K1111
100000000000000000000000000000000000000000000000000000000000000000000000000000000000001111
100000000000000000000000000000000000000000001111111111111111111100010001111111111000001111
1K00000000000000000000000000000000000000000K1                  100010001     1111000001111
111111011111111111111110001111111111100111111                  100010001     1111001001111
1111110111111         10001         1001                       100010001     1111001001111
1111110111111         10001         1001                       100010001     1111001001111    
1111110111111         10001         100111111111111111111111111110010011111111111001001111
1000000000001         10001         1001K0000000000000000000000000000000000001111001001111    
1000000000001         10001         1001000000000000000000000000000000000000K1111001001111    
1000000000001         11111         100111111111111111111111111111111111111111111001001111    
1111000011111111111111111111111111111D111111                                11110010011111 
100000000000000000000000000000000000000000001                                1111001001111  
100000000000000000000000000000000000000000001                                1111001001111  
1111110111111111111111100011111111111001111111111111111111111111111111111111111111D1D11111 
1K0000000000000000000000000000000000000000000100000000000000000000000000000000000000000001
1000000000000000000000000000000000000000000000000000000000000000000000000000000000000000K1
111111111111111111111111111111111111111111111111111111111111111111111111111111111111111111
111111111111111111111111111111111111111111111111111111111111111111111111111111111111111111
111111111111111111111111111111111111111111111111111111111111111111111111111111111111111111