NO ./textures/redbrick.xpm
SO ./textures/colorstone.xpm
WE ./textures/north.xpm

EA ./textures/wood.xpm
F 115,111,1
C 124,30,9


111111111111111
110000010011001
110011111111001
11001111 111001
110111111100111
1101110000001111111111111111
11011100000000000000000000011
10000000110011111111111111111
1000N0001100111
111111111111111