NO ./textures/blue.xpm
SO ./textures/grey.xpm
WE ./textures/hitler.xpm
EA ./textures/wood.xpm

F 115,111,1
C 124,30,9


111111111111111
110000010011001
110011111111001
11001111 111001
110111111100111
1101110000001111111111111111
110111000N0000000000000000011
10000000110011111111111111111
100000001100111
111111111111111