NO ./textures/banner.xpm
SO ./textures/blue.xpm
WE ./textures/grey.xpm

EA ./textures/door.xpm
C    10,10,155
F    114,114,114

        111111111111111111111111
        100000000000000000000001
        101000000000000000000001
        100000000000W00000000001
11111111101000000000000000000001
100000000011000001110111111111111
11110111111111011100000010001  
11111111111111111111111111111
1   1                       1
111111111111111111111111111
1001000001000001100100001001
10000010000000001101000010001
110100011110101110001110001111
11110111 1110101 101111010001
11111111 1111111 111111111111
