
set_textureset_texture
        111111111111111111111111
        1000000000110000000000001
        1011000001110000001000001
        100100000000000000001D101
111111111011000001110000000010101
100000000011000001110111111111111
111101111111110111  1
    1         1     1    
11111111111111111111111111111
1   1                       1
111111111111111111111111111
100100N001000001100100001001
10000010000000001101000010001
110100011110101110001110001111
11110111 1110101 101111010001
11111111 1111111 111111111111
